11111111111111111
10000110000000001
10000000C00000001
100000C0000C00001
1000P00000000E001
11111111111111111