111111111111111111111111111111
100000000000110000000000000001
1000P0000000110000000000000001
100000000000110000000C00000001
1000000C00000000E0000000000001
1000000000000C0000000000000001
100000000001111000000011111001
111111111111111111111111111111