111111111111111111111111111111111111111111111111111111111
100000000000001100000000000000000000001100000000000000001
100000P00000001100000000000000000000011000000C00000000001
100000000000001100000000000C000000000011000000000E1110001
100000000C00000000000000000000000000001100000000000011001
100000000000000C000000000000000000000000000C0000000011001
100000000000011110000000000011111000000000000000001100001
111111111111111111111111111111111111111111111111111111111